

#        B  #
#     #     #
#           #
#     #     #
#           #
#     #     #
#  A        #
